{
    "16": -1,
    "22": -1,
    "12": -1,
    "7": -1,
    "24": -1,
    "17": -1,
    "19": -1,
    "8": -1,
    "6": -1,
    "11": -1,
    "14": -1,
    "21": -1,
    "13": -1,
    "18": -1,
    "9": -1,
    "10": -1,
    "15": -1,
    "23": -1
}