{
    "6": -1,
    "10": -1,
    "5": -1,
    "22": -1,
    "13": -1,
    "15": -1,
    "20": -1,
    "19": -1,
    "8": -1,
    "16": -1,
    "24": -1,
    "11": -1,
    "17": -1,
    "7": -1
}