{
    "16": -1,
    "18": -1,
    "15": -1,
    "30": -1,
    "26": -1,
    "21": -1,
    "11": -1,
    "13": -1,
    "22": -1,
    "28": -1,
    "8": -1,
    "9": -1,
    "27": -1,
    "29": -1,
    "25": -1,
    "20": -1,
    "10": -1,
    "24": -1,
    "31": -1,
    "7": -1,
    "23": -1,
    "17": -1
}