{
    "15": 9,
    "20": 4,
    "14": 8,
    "17": 1,
    "16": 0,
    "9": 3,
    "7": 1,
    "10": 4,
    "18": 2,
    "21": 5,
    "19": 3,
    "8": 2,
    "13": 7,
    "11": 5,
    "6": 0,
    "12": 6
}