{
    "16": 0,
    "6": 0,
    "14": 8,
    "18": 2,
    "19": 3,
    "17": 1,
    "12": 6,
    "13": 7,
    "10": 4,
    "11": 5,
    "9": 3,
    "15": 9,
    "20": 4,
    "8": 2,
    "7": 1
}