{
    "25": -1,
    "21": -1,
    "14": -1,
    "27": -1,
    "23": -1,
    "10": -1,
    "16": -1,
    "17": -1,
    "28": -1,
    "18": -1,
    "12": -1,
    "24": -1,
    "13": -1,
    "15": -1,
    "26": -1,
    "11": -1,
    "20": -1,
    "22": -1,
    "19": -1
}