{
    "23": -1,
    "13": -1,
    "12": -1,
    "6": -1,
    "5": -1,
    "22": -1,
    "9": -1,
    "16": -1,
    "8": -1,
    "21": -1,
    "18": -1,
    "17": -1,
    "19": -1,
    "10": -1,
    "14": -1,
    "20": -1,
    "7": -1
}