{
    "23": -1,
    "15": -1,
    "20": -1,
    "26": -1,
    "14": -1,
    "22": -1,
    "29": -1,
    "19": -1,
    "16": -1,
    "13": -1,
    "28": -1,
    "7": -1,
    "18": -1,
    "21": -1,
    "10": -1,
    "11": -1,
    "32": -1,
    "6": -1,
    "12": -1,
    "8": -1,
    "30": -1,
    "27": -1,
    "17": -1,
    "5": -1,
    "9": -1
}