{
    "23": -1,
    "15": -1,
    "11": -1,
    "21": -1,
    "7": -1,
    "12": -1,
    "13": -1,
    "6": -1,
    "31": -1,
    "26": -1,
    "8": -1,
    "10": -1,
    "25": -1,
    "30": -1,
    "20": -1,
    "29": -1,
    "22": -1,
    "27": -1,
    "14": -1
}