{
    "4": -1,
    "15": -1,
    "17": -1,
    "10": -1,
    "9": -1,
    "13": -1,
    "11": -1,
    "16": -1,
    "19": -1,
    "6": -1,
    "12": -1,
    "14": -1
}