{
    "10": -1,
    "7": -1,
    "9": -1,
    "5": -1,
    "4": -1,
    "6": -1,
    "8": -1
}