{
    "10": -1,
    "19": -1,
    "20": -1,
    "11": -1,
    "21": -1,
    "8": -1,
    "14": -1,
    "16": -1,
    "13": -1,
    "9": -1,
    "15": -1,
    "12": -1,
    "18": -1
}