{
    "23": -1,
    "21": -1,
    "16": -1,
    "25": -1,
    "19": -1,
    "20": -1,
    "18": -1,
    "26": -1,
    "17": -1,
    "24": -1,
    "28": -1,
    "27": -1
}