{
    "19": -1,
    "12": -1,
    "23": -1,
    "18": -1,
    "9": -1,
    "14": -1,
    "11": -1,
    "25": -1,
    "17": -1,
    "4": -1,
    "20": -1,
    "13": -1,
    "21": -1,
    "7": -1,
    "10": -1,
    "6": -1,
    "8": -1,
    "5": -1,
    "16": -1,
    "15": -1,
    "22": -1
}