{
    "5": -1,
    "18": -1,
    "19": -1,
    "14": -1,
    "10": -1,
    "7": -1,
    "11": -1,
    "4": -1,
    "16": -1,
    "13": -1,
    "21": -1,
    "20": -1,
    "6": -1,
    "9": -1
}