{
    "20": -1,
    "5": -1,
    "18": -1,
    "7": -1,
    "17": -1,
    "14": -1,
    "11": -1,
    "12": -1,
    "6": -1,
    "23": -1,
    "8": -1,
    "10": -1,
    "9": -1,
    "22": -1,
    "4": -1
}