{
    "5": -1,
    "8": -1,
    "21": -1,
    "14": -1,
    "17": -1,
    "23": -1,
    "13": -1,
    "10": -1,
    "4": -1,
    "9": -1,
    "19": -1,
    "24": -1,
    "7": -1,
    "12": -1,
    "11": -1,
    "6": -1,
    "20": -1,
    "15": -1,
    "16": -1
}