{
    "16": -1,
    "20": -1,
    "14": -1,
    "23": -1,
    "13": -1,
    "11": -1,
    "9": -1,
    "21": -1,
    "7": -1,
    "12": -1,
    "17": -1,
    "15": -1,
    "8": -1,
    "19": -1,
    "6": -1,
    "10": -1,
    "22": -1
}