{
    "10": -1,
    "23": -1,
    "21": -1,
    "9": -1,
    "24": -1,
    "6": -1,
    "22": -1,
    "12": -1,
    "20": -1,
    "13": -1,
    "19": -1,
    "7": -1,
    "11": -1,
    "8": -1
}