{
    "17": -1,
    "34": -1,
    "18": -1,
    "27": -1,
    "16": -1,
    "19": -1,
    "31": -1,
    "35": -1,
    "24": -1,
    "25": -1,
    "30": -1,
    "26": -1,
    "29": -1,
    "10": -1,
    "37": -1,
    "13": -1,
    "33": -1,
    "39": -1,
    "15": -1,
    "12": -1,
    "32": -1,
    "21": -1,
    "23": -1,
    "36": -1
}