{
    "14": -1,
    "22": -1,
    "4": -1,
    "18": -1,
    "24": -1,
    "21": -1,
    "26": -1,
    "31": -1,
    "34": -1,
    "35": -1,
    "7": -1,
    "10": -1,
    "16": -1,
    "37": -1,
    "38": -1,
    "27": -1,
    "13": -1,
    "20": -1,
    "30": -1,
    "29": -1,
    "6": -1,
    "5": -1,
    "32": -1,
    "9": -1,
    "15": -1,
    "19": -1,
    "36": -1,
    "25": -1,
    "28": -1,
    "33": -1,
    "17": -1,
    "23": -1,
    "12": -1,
    "8": -1
}