{
    "16": -1,
    "22": -1,
    "20": -1,
    "7": -1,
    "11": -1,
    "10": -1,
    "12": -1,
    "23": -1,
    "5": -1,
    "21": -1,
    "25": -1,
    "24": -1,
    "18": -1,
    "6": -1
}