{
    "5": -1,
    "14": -1,
    "7": -1,
    "8": -1,
    "15": -1,
    "12": -1,
    "18": -1,
    "20": -1,
    "6": -1,
    "10": -1,
    "9": -1,
    "11": -1,
    "19": -1,
    "17": -1,
    "16": -1,
    "13": -1,
    "22": -1,
    "4": -1
}