{
    "23": -1,
    "11": -1,
    "16": -1,
    "19": -1,
    "13": -1,
    "20": -1,
    "6": -1,
    "17": -1,
    "21": -1,
    "22": -1,
    "26": -1,
    "7": -1,
    "12": -1,
    "18": -1,
    "5": -1,
    "8": -1,
    "14": -1,
    "24": -1,
    "27": -1,
    "29": -1
}