{
    "11": -1,
    "24": -1,
    "5": -1,
    "17": -1,
    "19": -1,
    "26": -1,
    "28": -1,
    "8": -1,
    "12": -1,
    "4": -1,
    "22": -1,
    "7": -1,
    "25": -1,
    "31": -1,
    "18": -1,
    "30": -1,
    "14": -1,
    "9": -1,
    "20": -1,
    "23": -1,
    "21": -1,
    "13": -1,
    "29": -1,
    "10": -1,
    "16": -1,
    "27": -1,
    "15": -1,
    "6": -1
}