{
    "13": 4,
    "23": 4,
    "21": 2,
    "15": 6,
    "17": 8,
    "14": 5,
    "19": 0,
    "16": 7,
    "20": 1,
    "22": 3,
    "18": 9
}
