{
    "11": 5,
    "23": 6,
    "16": 0,
    "12": 6,
    "17": 1,
    "9": 3,
    "6": 0,
    "18": 2,
    "22": 5,
    "8": 2,
    "21": 4,
    "13": 7,
    "7": 1,
    "10": 4,
    "15": 9,
    "14": 8
}