{
    "20": 6,
    "24": 8,
    "17": 3,
    "18": 4,
    "25": 9,
    "14": 1,
    "27": 1,
    "13": 0,
    "19": 5,
    "23": 7,
    "15": 2
}
