{
    "4": 0,
    "5": 0,
    "13": 0,
    "20": 0,
    "6": 0,
    "11": 0,
    "7": 0,
    "14": 0,
    "17": 0,
    "18": 0,
    "10": 0,
    "19": 0,
    "15": 0,
    "8": 0,
    "9": 0
}